35
99 14 82 18 81 81 73 51 68 32 29 55 48 68 25 55 58 40 10 76 91 45 65 83 77 14 70 94 46 57 15 22 97 21 52
28 99 88 78 21 94 71 37 39 45 73 80 57 20 31 83 54 35 90 35 41 35 40 75 18 90 32 10 44 30 17 38 14 50 28
77 48 41 74 91 61 69 71 65 27 52 73 55 80 56 100 66 16 19 44 79 34 80 57 16 54 41 70 41 23 26 42 49 62 69
71 84 46 98 47 58 16 56 21 82 60 58 69 17 39 63 18 13 54 46 41 78 39 40 21 63 54 51 66 97 24 68 67 73 40
13 90 74 15 17 35 100 47 19 69 51 29 65 74 88 99 43 71 14 49 65 36 17 46 75 98 84 32 32 38 51 20 65 16 35
22 79 10 18 37 48 14 30 47 44 15 57 52 38 17 44 31 76 33 68 73 44 97 89 52 100 33 20 93 31 93 43 14 76 66
75 30 89 45 75 50 77 17 66 55 40 38 69 26 45 18 19 84 97 85 64 40 38 44 33 49 45 72 71 22 60 78 12 44 50
98 30 66 40 93 12 59 76 59 61 19 46 63 12 27 54 52 77 19 40 36 73 48 16 20 100 89 61 89 13 16 45 41 70 25
62 93 15 59 73 48 31 33 54 83 78 52 45 26 13 64 87 52 16 52 61 17 25 76 16 43 76 39 37 87 66 36 43 48 62
25 22 49 95 40 23 43 79 53 37 84 47 91 53 99 41 100 29 68 35 31 74 46 32 71 81 86 43 22 30 93 37 45 96 43
60 41 34 43 67 84 99 32 39 56 20 32 86 83 48 35 62 98 39 61 58 100 73 19 26 22 61 85 11 89 48 44 47 92 28
46 62 40 21 33 44 94 67 90 77 97 20 75 84 14 14 21 27 74 64 86 55 28 26 37 37 67 90 20 37 82 69 22 20 62
31 81 87 95 84 55 58 24 45 19 62 31 97 87 67 32 75 20 43 76 35 25 28 23 13 33 22 24 92 63 84 55 86 79 84
45 86 61 72 95 25 19 53 23 23 74 28 44 63 30 17 97 25 37 87 22 83 54 88 36 100 12 82 50 72 21 11 97 52 45
97 82 62 82 94 80 83 68 27 90 96 56 39 76 40 29 60 37 40 88 81 69 76 18 85 94 86 84 16 98 70 67 21 70 80
99 17 83 73 52 40 79 92 24 82 24 41 43 82 88 70 92 71 47 71 85 81 11 73 64 47 33 62 43 95 58 89 92 82 53
15 27 78 88 16 47 16 71 43 40 68 71 39 15 86 55 61 35 48 69 66 11 47 16 10 100 32 24 38 61 28 48 39 50 77
51 40 23 23 78 57 73 56 58 77 27 36 77 92 75 62 39 73 51 21 75 13 100 46 52 18 22 88 15 76 39 38 94 49 10
13 69 36 30 72 66 46 34 29 31 38 73 91 29 81 59 62 16 78 40 62 26 20 64 42 61 20 71 28 73 92 16 89 57 63
47 68 72 97 26 79 93 41 28 100 41 84 72 23 69 65 64 15 79 58 65 15 38 80 57 55 25 97 90 100 79 83 86 70 82
90 13 19 58 94 92 57 81 68 27 65 92 66 61 73 45 20 81 72 62 99 90 72 89 18 67 18 44 26 52 51 41 63 55 96
85 42 38 78 77 54 19 20 23 33 91 72 64 99 71 61 63 100 25 48 94 73 15 87 81 60 13 48 72 39 11 35 84 48 76
40 99 28 96 96 51 63 87 24 87 13 91 78 46 78 85 71 28 96 59 29 75 17 64 80 14 17 71 89 40 44 23 85 65 59
44 78 59 86 51 74 18 55 13 42 11 65 93 47 55 91 45 41 37 10 60 10 85 29 20 43 34 70 33 91 37 70 36 98 38
74 54 17 22 96 55 20 11 29 41 80 36 16 49 80 28 53 54 24 15 54 34 48 47 84 77 57 82 68 62 67 42 65 24 34
55 68 83 70 12 27 18 80 60 52 16 10 86 75 79 52 59 32 38 23 25 93 71 88 11 15 71 64 89 70 11 73 97 99 90
29 56 77 11 67 86 75 84 49 41 42 29 77 56 52 90 67 36 60 18 61 57 91 49 45 68 34 41 36 76 13 26 13 31 10
13 30 96 64 98 97 31 54 81 94 35 19 77 49 83 27 10 61 52 55 61 81 15 75 76 22 80 78 93 85 35 63 94 31 39
43 17 67 39 24 79 53 14 51 71 63 57 66 22 15 26 25 10 36 57 22 44 86 14 13 57 74 21 95 92 50 28 78 28 15
54 26 77 11 53 83 59 79 39 10 98 83 35 15 22 16 38 96 97 22 43 81 39 47 56 76 12 97 55 50 96 32 26 17 92
34 24 97 58 86 46 56 24 62 70 64 97 36 33 88 41 76 70 66 64 96 67 26 83 59 15 28 21 24 82 52 26 51 11 99
77 46 22 14 73 99 31 38 66 88 53 67 64 61 13 45 91 83 25 31 91 38 90 64 79 72 28 48 93 86 61 78 82 25 52
80 96 32 66 62 96 22 78 14 97 58 42 74 43 62 90 15 33 99 84 68 78 28 29 76 58 50 55 47 49 100 14 42 89 17
97 68 69 82 80 29 72 57 24 89 23 33 53 100 76 35 52 49 45 42 75 51 29 64 52 78 92 83 53 62 84 55 73 21 84
91 23 95 19 20 16 85 25 65 48 56 42 56 66 57 52 49 50 99 93 12 19 17 65 59 66 59 28 28 34 95 86 71 28 71
